8x15
###############
#-----#V----o-#
#-o-----@-----#
#----#-------@#
######----o--##
#@------#----##
#--X--@-----@-#
###############