8x20
####################
#o-----V-@-----##-o#
####--------@------#
#-#@-----o---------#
#-#############---o#
#--o-------@------##
#@---X-o-------@---#
####################

