7x22
######################
#-----oV----@---#----#
#--@-----------o----##
########--o-------@#-#
#X---@-----###--o----#
#------o----#-------@#
######################